#######
#  $ .#
#     #
## @ ##
#     #
#. $  #
#######