###############
#.$           #
#           $.#
### ###########
#     #        
#  @  #        
#######        