#######
#.$   #
#   $.#
### ###
#     #
#  @  #
#######
